; аббревиатуры
АГА=агэА
АГС=агэЭс
АК=акА
АКМ=аКаЭМ
АКС=акаЭс
АНБ/i
АНБ=аэНБЭ
АПЛ/i
АПСБ=аПээСБЭ
АРТ=аэРТЭ
АССР/i
АТВ=атэвЭ
АХ=ахА
БМП=бээмпЭ
БМПТ=БээМПэТЭ
БПЛА/i
БТР=БэТэЭР
ВБПГ=ВэБэПэГЭ
ВВС=ВэВэЭС
ВКП (б)=ВэКаПэ (бЭ)
ВМБ=ВээМБЭ
ВМС=ВэМэЭС
ВМСЗ=ВээМэСЗЭ
ВМФ=ВэМэЭФ
ВПБГ=ВэПэБэГЭ
ВСУ/i
ВСУ=ВэСэУ
ГБ=ГэБЭ
ГИБДД=гибэдэд+э
ГП=ГэПЭ
ГПТ=ГэПэТЭ
ГСМ=ГээСЭМ
ГШ=ГэША
ДЖ=ДэЖЭ
ДШМГ=ДэШаэМГЭ
ЗА=ЗэА
ИПП=иПэПЭ
КБЧ=КаБэЧЭ
КВ=КаВЭ
КГБ=КэГэБЭ
КПС=КаПэЭС
КПСС=КаПээСЭС
КС=КаЭС
КСАПО=КаэСаПэО
КСП=КаэСПЭ
МЗП=эМЗэПЭ
ММГ=эмэмгЭ
МО/i
МО=эМО
МПЛ=эмпэЭл
МТЛБ=эМТээЛБЭ
МТТ=эМТэТЭ
Н+АСА
НАТО=НАТо
НЗ=эНЗЭ
НКВД=эНКаВэДЭ
НКПС=эНКаПэЭС
НЛА=эНэЛА
НЛО=эНэЛО
НСВТ=эНэСВэТЭ
ОБСЕ/i
ОГПУ=оГэПэУ
ОЗК=оЗэКА
ОКБ/i
ОКВ=оКаВЭ
ООН=+О&ОН
ОПГ=оПэГэ
ОТК=оТэКА
ОХ=охА
ПББС=ПэБэБэЭС
ПБГ=ПэБэГЭ
ПВ=ПэВЭ
ПВО=ПэВэО
ПДСС=ПэДээСЭС
ПЗ=ПэЗЭ
ПЗРК=ПэЗээРКА
ПКМ=ПэКаЭМ
ПМЖ=ПээМЖЭ
ПНВ=ПээНВЭ
ППДСС=ПэПэДээСЭС
ПРГ=ПээРГЭ
ПХД=ПэХаДЭ
РККА/i
РПГ=эРПэГЭ
РПК=эРПэКА
СБ=эСБЭ
СВД=эСВэДЭ
СМ=эСЭМ
СНГ=эСэНГЭ
СПГ=эСПэГЭ
СПС=эСПэЭС
СПУ=эСПэУ
СПШ=эСПэША
СТПВ=эСТэПэВЭ
СФ=эСЭФ
СШУ=эСШаУ
ТД=ТэДЭ
ТЗК=ТэЗэКА
ТТ=ТэТЭ
ТТХ=ТэТэХА
УЗРГМов=уЗээРГэЭМов
УКВ/i
УКВ=УКаВЭ
УНКВД=УэНКаВэДЭ
УС=УЭС
ФБР=эФБэЭР
ФПС=эФПэЭС
ФСБ=эФэСБЭ
ХБ=ХэБЭ
ЦС=цэЭс
ЧП=ЧэПЭ
ЧС=ЧэЭС
ЭСЗ=ээСЗЭ
ЮС=ЮЭС
ЮСАРМИ=ЮэСАРМи