; 01 ; This dictionary for Ukrainian voices which are part of RHVoice Speech Synthesizer (https://github.com/Olga-Yakovleva/RHVoice) OR (https://github.com/RHVoice) contains the rules for the correct pronunciation of Ukrainian words and abbreviations.
; 02 ; This dictionary is distributed under LGPL v2.1 or later.
; 03 ; Copyright (C) 2020 DictionaryTeam (https://github.com/RHVoice)
; 04 ; DictionaryTeam:
; 05 ; ANT Berezhnyi <velmyshanovnyi@gmail.com> | www.t.me/velmyshanovnyi
; 
ACCT=A C C T
ACV=A C V
AD=ей ді
AFAIK=A F A I K
AG=A G
AGR=A G R
AKA=A K A
ASAP=асап
BASF=басф
BC=B C
BCE=B C E
BD=B D
BRB=B R B
BRD=B R D
BTW=B T W
CA=C A
CAD=C A D
CEO=C E O
CFO=C F O
CIO=C I O
CMO=C M O
COD=C O D
COGS=C O G S
CPA=C P A
CTO=C T O
DECT=D E C T
DEFA=D E F A
DOBRUS=D O B R U S
EDI=E D I
EDIFACT=E D I F A C T
EH=E H
EMC=E M C
EMS=E M S
ERMES=E R M E S
ETA=E T A
EXP=E X P
FBF=F B F
FIFO=F I F O
GCP=G C P
GDP=G D P
GLP=G L P
GMP=G M P
GP=G P
GPP=G P P
GPS=G P S
GSM=G S M
GmbH=G m b H
HBh=H B h
IMHO=I M H O
ISDN=I S D N
IT=I T
IUPAC=іюпак
LAN=лан
MA=M A
MAN=ман
MCM=M C M
MO=M O
MWSt=M W S t
NSDAP=N S D A P
NSFW=N S F W
ODA=O D A
OSI=O S I
PC=P C
PISN=P I S N
PS=P S
PSPDN=P S P D N
PSTN=P S T N
PTN=P T N
Pls=P l s
PnL=P n L
Qty=Q t y
RLY=R L Y
ROI=R O I
SCADA=S C A D A
SD=S D
SFW=S F W
SGML=S G M L
SMH=S M H
SP=S P
SchR=S c h R
SkR=S k R
Sls=S l s
TBT=T B T
TBT=T B T
TETRA=тетра
TIA=T I A
TIA=T I A
TTYL=T T Y L
TTYL=T T Y L
Trnsfr=T r n s f r
Trnsfr=T r n s f r
UNESCO=юн+еско
UNO=уно
USA=ю ес ей
USB=ю ес бе
VIP=віп
WAN=W A N
WAN=ван
WCW=W C W
WPW=W P W
WPW=W P W
Wrldwd=W r l d w d
Wrldwd=W r l d w d
Wst=W s t
Wst=W s t
ЄДРПОУ=є де ер пе о у
ЄОПП=Є О П П
ЄОУО=Є О У О
ЄС=ЄС
ІКТ=І К Т
ІНО=І Н О
ІПКСФ=І П К С Ф
ІСВ=І С В
ІЧ=І Ч
ААД=А А Д
АБ=А Б
АЕС=А Е С
АЙРЕКС=ай рекс
АКБ=а ка бе
АКТГ=А К Т Г
АМФ=А М Ф
АН=А Н
АНД=А Н Д
АОЗТ=А О З Т
АООТ=А О О Т
АПК=А П К
АПН=А П Н
АПФ=А П Ф
АРА=А Р А
АРААГРУ=А Р А А Г Р У
АРК=А Р К
АСД=А С Д
АСРР=А С Р Р
АТ=А Т
АТВТ=А Т В Т
АТЗТ=А Т З Т
АТО=А Т О
АТФ=А Т Ф
АУ=А У
АФІ=А Ф І
БАД=бад
БАР=Б А Р
БАС=Б А С
БАСФ=басф
ББК=Б Б К
БМЭ=Б М Э
БСРР=Б С Р Р
БСЭ=Б С Э
БТФ=Б Т Ф
БУПР=Б У П Р
БЧЛ=Б Ч Л
ВІЛ=віл
ВАК=вак
ВАРНІТСО=В А Р Н І Т С О
ВАТ=ват
ВВП=ве ве пе
ВДВС=В Д В С
ВДНГ=ве&де&ен&ге
ВДШ=В Д Ш
ВЕРХ=В&Е&Р&Х
ВИШ=виш
ВКВУ=В К В У
ВКП(б)=ве&ка&пе&б+е
ВКПб=ве&ка&пе&б+е
ВМС=ве ем ес
ВНЗ=ве ен зе
ВНП=В Н П
ВНУС=В Н У С
ВО=ве&о
ВООЗ=В&О&О&З
ВОХР=вохр
ВПК=ве пе ка
ВР=ве&ер
ВРНГ=В Р Н Г
ВРХ=В Р Х
ВТИШ=В Т И Ш
ВТТ=ве&те&те
ВУАМЛІН=В У А М Л І Н
ВУАН=В У А Н
ВУК=вук
ВУРПС=В У Р П С
ВУСПС=В У С П С
ВУЦВК=В У Ц В К
ВУЦИК=В У Ц И К
ВУЧК=В У Ч К
ВЦКНС=В Ц К Н С
ВЦРПС=В Ц Р П С
ВЧ=В Ч
ВЧК=В Ч К
ГІБДД=гі&бе&де&д+е
ГІС=гіс
ГАМК=Г А М К
ГВУЗ=Г В У З
ГДК=Г Д К
ГЕР=Г Е Р
ГКП=Г К П
ГМГ-КоА=Г&М&Г&К&о&А
ГО=ге&о
ГП=ге пе
ГРВІ=ге&ер&ве&і
ГРК=ге&ер&ка
ГТУЮ=Г Т У Ю
ГУ=гу
ГУЛАГ=гулаг
ГУМВС=гу ем ве ес
ГЦНТІ=Г Ц Н Т І
ДІНО=Д І Н О
ДІФ=діф
ДА=Д А
ДАБІ=дабі
ДАЗО=да зо
ДАМВС=да ем ве ес
ДАСБУ=да ес бе у
ДАХО=дахо
ДВЗ=де ве зе
ДВНЗ=Д В Н З
ДЕА=Д Е А
ДЕФА=Д Е Ф А
ДЗ=Д З
ДКУД=Д К У Д
ДМСО=Д М С О
ДМФА=Д М Ф А
ДМШ=де ем ша
ДНК=де ен ка
ДНУ=Д Н У
ДНЦЛЗ=Д Н Ц Л З
ДОПР=Д О П Р
ДПТ=Д П Т
ДПУ=Д П У
ДР=Д Р
ДСТУ=де ес те у
ДТП=де те пе
ДФ=де пе
ДФУ=Д Ф У
ДФЦ=Д Ф Ц
ДЦ=Д Ц
ЕАММ=Е А М М
ЕЕ=Е Е
ЕКГ=е ке ге
ЕОМ=Е О М
ЕПР=Е П Р
ЕТТ=Е Т Т
ЖЧК=Ж Ч К
ЗАГС=загс
ЗАТ=зат
ЗМІ=З М І
ЗМД=З М Д
ЗНО=зе не о
ЗОШ=зош
ЗПСШ=З П С Ш
ЗУНР=зунр
КБ=ка бе
КВК=ка ве ка
КДБ=ка де бе
КДЦ=К Д Ц
КЗ=ка зе
КЗпП=К З пП
КК=К К
ККД=ка ка де
КМУ=ка ме у
КНС=ка не ес
КОВО=К О В О
КП(б)У=К П (б ) У
КПІ=ка пе і
КПРС=ка пе ер ес
КПУ=ка пе у
КСМ=К С М
ЛЗ=Л З
ЛКСМУ=Л К С М У
ЛП=Л П
ЛР=Л Р
ЛРС=Л Р С
МІАС=М І А С
МАСРР=М А С Р Р
МАУП=М А У П
МВК=М В К
МВС=М В С
МВСГУРСМ=М В С Г У Р С М
МВСДАРФ=М В С Д А Р Ф
МВФ=ем ве еф
МДБ=ем де бе
МДУ=М Д У
ММД=М М Д
ММЕ=М М Е
МО=ем о
МОГП=М О Г П
МОДР=М О Д Р
МОЗ=моз
МОК=мок
МОН=мон
МП=М П
МПК=М П К
МТС=М Т С
МТТ=ем те те
НААН=Н А А Н
НАДФ=Н А Д Ф
НАКККіМ=Н А К К К і М
НАМН=Н А М Н
НАН=нан
НАНУ=нан у
НАПН=Н А П Н
НАСУС=Н А С У С
НАФ=Н А Ф
НБ=Н Б
НБУ=набу
НВЧ=Н В Ч
НДС=не де ес
НК=Н К
НКВС=Н К В С
НКВСУНО=Н К В С У Н О
НКВТ=Н К В Т
НКДБ=Н К Д Б
НКЗС=Н К З С
НКО=Н К О
НКРЕКП=Н К Р Е К П
НКРСІ=Н К Р С І
НКШС=Н К Ш С
НКЮ=Н К Ю
НМАПО=Н М А П О
НМС=Н М С
ННІ=Н Н І
ННЦ=Н Н Ц
НПЗП=Н П З П
НПО=Н П О
НРЖУ=Н Р Ж У
НСДАП=Н С Д А П
НСТУ=Н С Т У
НТД=Н Т Д
НТШ=Н Т Ш
НФаУ=Н Ф аУ
НЧ=Н Ч
ОАО=О А О
ОВ=О В
ОВК=О В К
ОВО=О В О
ОДВ=О Д В
ОДВУ=О Д В У
ОДП=О Д П
ОДПУ=О Д П У
ОКР=О К Р
ОО=О О
ООН=О О Н
ООО=О О О
ООС=о о ес
ОПУ=о пе у
ОР=О Р
ОСГ=О С Г
ОУН=О У Н
ПАБК=П А Б К
ПАР=П А Р
ПАСК=П А С К
ПБ=пе бе
ПДВ=пе де ве
ПК=П К
ПКВО=П К В О
ПМР=П М Р
ПП=П П
ППО=П П О
ПТУ=пе те у
ПУ=П У
РІПО=Р І П О
РАТАУ=Р А Т А У
РВВ=Р В В
РВВС=Р В В С
РВК=Р В К
РВР=Р В Р
РВС=Р В С
РГР=Р Г Р
РДАЕ=Р Д А Е
РДАЛМ=Р Д А Л М
РДАСПІ=Р Д А С П І
РДВА=Р Д В А
РЗК=ер зе ка
РИО=Р И О
РК=ер ка
РКП(б)=ер ка пе бе
РМ=Р М
РМТ=Р М Т
РН=Р Н
РНК=ер ен ка
РОЕ=рое
РПК=ер пе ка
РПО=Р П О
РР=Р Р
РСІ=Р С І
РСІНКТ=Р С І Н К Т
РСІЦКС=Р С І Ц К С
РСДРП(б)=Р С Д Р П (б )
РСДРП=Р С Д Р П
РСМ=Р С М
РСМДА=Р С М Д А
РСМУРСР=Р С М У Р С Р
РСФРР=Р С Ф Р Р
РСЧА=Р С Ч А
РФ=ер еф
СІАМАК=С І А М А К
САПР=сапр
СБУ=ес бе у
СБУАХЧУ=С Б У А Х Ч У
СБУДВА=ес бе у два
СВБ=С В Б
СВУ=ес ве у
СЕС=С Е С
СКВО=С К В О
СНІД=сн+ід
СНД=ес&ен&де
СНК=С Н К
СОТ=сот
СП=ес&пе
СПВ=С П В
СРП=С Р П
СРСР=есер есер
СРСРУЦК=С Р С Р У Ц К
СС=ес+ес
СТБ=ес&те&бе
СТВ=С Т В
СТО=есте о
СУГС=С У Г С
СУЕМ=С У Е М
СУЕО=С У Е О
СУС=С У С
США=се&ше&а
ТДАТУ=Т Д А Т У
ТДД=Т Д Д
ТНК=те ен ка
ТОВ=тов
ТОН=тон
ТОО=Т О О
ТПВ=Т П В
ТУУ=Т У У
ТФ=Т Ф
ТФСУ=Т Ф С У
ТЦ=Т Ц
ТШХ=Т Ш Х
ТзОВ=Т зО В
УІЖ=У І Ж
УААН=У А А Н
УБД=у&бе&де
УБК=у&бе&ка
УВМА=У В М А
УВО=уво
УВООПК=У В О О П К
УВОПУН=У В О П У Н
УВУ=У В У
УВЧ=У В 
УГК=У Г К
УГКЦ=у&ге&ка&це
УГПЦ=У Г П Ц
УДБ=У Д Б
УДК=У Д К
УДХТУ=У Д Х Т У
УЕН=У Е Н
УЕР=У Е Р
УЖНР=У Ж Н Р
УЗД=у зе де
УКРО=У К Р О
УКХ=У К Х
УМВС=у ем ве ес
УНІБ=уніб
УНГО=У Н Г О
УНДІП=У Н Д І П
УНДО=У Н Д О
УНКВС=У Н К В С
УНН=у ен ен
УНР=у ен ер
УНРУЧК=У Н Р У Ч К
УНС=у ен ес
УНСО=унс+о
УНЦ=У Н Ц
УОО=У О О
УПСР=У П С Р
УРП=У Р П
УРСМ=У Р С М
УСБУ=у ес бе у
УСДРП=У С Д Р П
УСРР=У С Р Р
УСРРУГКЦ=У С Р Р У Г К Ц
УСХД=У С Х Д
УТОРНІТСО=У Т О Р Н І Т С О
УФ=у еф
УкрДГРІ=У к р Д Г Р І
ФК=Ф К
ФП=Ф П
ФПГ=Ф П Г
ФРН=Ф Р Н
ФС=Ф С
ФСБ=Ф С Б
ХІНГ=Х І Н Г
ХІНО=Х І Н О
ХГМИ=Х Г М И
ХГТ=Х Г Т
ХДАУ=Х Д А У
ХДМІ=Х Д М І
ХДМА=Х Д М А
ХДУ=Х Д У
ХМАПО=Х М А П О
ХМД=Х М Д
ХНТУ=Х Н Т У
ХОБД=Х О Б Д
ХОБЮ=Х О Б Ю
ХОГО=Х О Г О
ХОЗЛ=Х О З Л
ХОНМБ=Х О Н М Б
ХООНСФХУ=Х О О Н С Ф Х У
ХОУНБ=Х О У Н Б
ХПЗ=Х П З
ХТЗ=Х Т З
ХТПП=Х Т П П
ХФІ=Х Ф І
ХФЗ=Х Ф З
ХЮІ=Х Ю І
ЦВК=Ц В К
ЦДІАК=Ц Д І А К
ЦДІАЛ=Ц Д І А Л
ЦДАВО=Ц Д А В О
ЦДАГО=Ц Д А Г О
ЦДАЗУки=Ц Д А З У к и
ЦДАМЛМ=Ц Д А М Л М
ЦДЕА=Ц Д Е А
ЦДКФФА=Ц Д К Ф Ф А
ЦДНТА=Ц Д Н Т А
ЦЕСУС=Ц Е С У С
ЦИК=цик
ЦК=це ка
ЦКК=це ка ка
ЦЛК=Ц Л К
ЦНС=це ен ес
ЦО=це о
ЦОГ=цог
ЦР=Ц Р
ЦСССДМ=Ц С С С Д М
ЦСУ=Ц С У
ЦУМ=цум
ЦУНГО=Ц У Н Г О
ЦЧО=Ц Ч О
ЦШ=Ц Ш
ЧК=Ч К
ЧКВЦВК=Ч К В Ц В К
ЧКУЧХ=Ч К У Ч Х
ЧОН=Ч О Н
ЧП=Ч П
ЧСР=Ч С Р
ЧСС=Ч С С
ШКТ=Ш К Т
ШОЕ=шо е
ЭЭ=Э Э
ЮЕ=Ю Е
ЮНЕСКО=юнеско
ЯМР=я ем ер
цАМФ=цавф
ҐмбГ=Ґ&ем&бе&ге
